Sciences Po / fonds CEVIPOF
République Française - Département de la Creuse - Elections Législatives du 28 Mars 1993 - 2e circonscription
Gaston RIMAREIX Député sortant
Candidat de rassemblement des forces de gauche et de progrès
Suppléant : Thierry CHANDERNAGOR Président du Conseil Général
Chère électrice, cher électeur,
J e remercie chacune et chacun d'entre vous qui m'avez accordé votre confiance dès le premier tour, dimanche dernier.
Malgré les difficultés que traverse notre pays : le chômage, la crise agricole et rurale, vous m'avez apporté votre soutien, reconnaissant ainsi les actions que j'ai menées au niveau national et au plan local pour défendre notre Département et mieux préparer son avenir.
Mais vous avez aussi manifesté avec force, par vos suffrages, votre profond mécontentement et vos inquiétudes face à un monde qui subit des bouleversements sans précédent et aussi parce que vous avez souvent le sentiment d'être abandonnés à votre sort par un pouvoir de plus en plus lointain.
Depuis 5 ans -et bien avant-, je me bats comme élu local et natio- nal pour faire entendre ce message. Votre vote de dimanche me conforte dans ma volonté et dans ma détermination.
J'en appelle aujourd'hui à la conscience et au bon sens de tous les Creusois. L'enjeu est d'importance. Dimanche prochain, ne vous trompez pas et ne compromettez pas, par désespoir, un avenir déjà si difficile.
A u plan national : Votre choix est clair. Il est sûr aujourd'hui que la droite aura une majorité écrasante, avec les déséquilibres et les risques qui pourraient en résulter et notamment la remise en cause des droits sociaux et les excès d'une politique libérale au détriment de l'agriculture et des zones rurales. A vous d'en tirer les conséquences et de faire barrage à ce raz-de-marée de la droite, en choisissant un homme dont l'autorité est reconnue et respectée, notamment sur les problèmes agricoles et d'aménagement du territoire.
A
u plan départemental : Vous pouvez choisir entre :
· Un homme dont les critiques sont démagogiques, les projets inexistants pour la Creuse, et dont les comportements intolérants et irresponsables, souvent proches de ceux de l'extrême droite, ne pourront que déconsidérer notre Département.
· Un homme compétent et expérimenté et qui a fait la preuve, à tous les niveaux, de sa maîtrise et de son calme, de son efficacité et de sa détermination. Un homme de tolérance et de rassemblement aussi, comme en témoigne l'appel de plus de 200 élus dont 80 Maires, 11 Maires de chefs-lieux de canton qui lui apportent leur soutien.
Dimanche, pour l'avenir de la Creuse, l'avenir de vos enfants, pre- nez vos responsabilités, ne vous trompez pas.
Tous les hommes de gauche et de progrès, tous les hommes épris de justice, de liberté, de démocratie et de solidarité doivent se rassembler, toutes les forces nouvelles parfois déçues par la politique doivent aussi se mobiliser
et voter Gaston RIMAREIX.Sciences Po / fonds CEVIPOF
COMITÉ DE SOUTIEN POUR LA CANDIDATURE DE Gaston RIMAREIX
Les Maires, Adjoints et Conseillers Municipaux soussignés, bien que ne partageant pas tous les idées politiques de Gaston RIMAREIX, reconnaissent le travail, les actions et les réalisations qu'il a effectués dans le Département au cours de son mandat.
AHUN : Christiane CHAUBIER (Marie), Claudine LUCANTIS, Raymond PICARAT (M. Adjoints)
ARFEUILLE CHATAIN : Raymond THIONNET (Maire)
AUBUSSON : Gilles PALLIER, Jean-Louis AZAIS, Madeleine LEONARD, Michel VACHERON (C. M.)
AUZANCES : André VENUAT (Maire et Conseiller Général), Pierre LAJOINIE, Michel CLUZEL, Jeanine DURAND, Marc PARROTIN (M. Adjoints) et la majorité du Conseil Municipal
BANIZE : Pierre DEVIERRE (M. Adjoint)
BASVILLE : Jean-François BRETTE (Maire)
BEISSAT : Marcel NIOLOUX (Maire)
BELLEGARDE-EN-MARCHE : Jean-Pierre BONNAUD (Maire)
BETETE : Alain PHILIPPON (C. M.)
BLAUDEIX : Fernand JOUANET (Maire)
BLESSAC : Robert CUISSET (Maire), Marcel LOULERGUE (M. Adjoint) BOSROGER : Jean-Claude MEAUME (Maire), Claudette JOULOT (M. Adjoint)
BOUSSAC : Jean-Claude DEVILARD (Maire et Conseiller Général), Bernard CARTE, Suzy PREVOST (M. Adjoints)
BOUSSAC-BOURG : Marcel DELECROIX (Maire)
BROUSSE : Andrée VENUAT (M. Adjoint)
BUDELIERE : Jean THOMAS (Maire), Jean-Pierre CITRON (M. Adjoint), Claude LAJOIE, Bernard LAPOUGE (C. M.)
BUSSIERE-SAINT-GEORGES : Gérard THOMAZON (Maire)
CELLETTE (LA) : Christian JULIEN (Maire)
CHAMBERAUD : André ROUDIER (Maire)
CHAMBON-SUR-VOUEIZE : Jean AUMASSON (Maire)
CHAMPAGNAT : René GAUMET (Maire)
CHARD : Serge PERRIER (Maire), Guy LEVY, Yves CONCHON, René LAPORTE (C. M.)
CHARRON : Marius NINY (Maire) CHATELARD (LE) : Elise JAMOT (M. Adjoint) CHATELUS-MALVALEIX : Jean-François BOUCHET (C. M.)
CHAUCHET (LE) : Robert BOUSSAGEON (M. Adjoint)
CHAUSSADE (LA) : Guy VIGNERON (M. Adjoint), René MAZUEL (M. Adjoint)
CHAVANAT : Robert AUVITY (Maire)
CHENERAILLES : Jean-Marie SINAUD (C. M.), François PARRY (C. M.) COURTINE (LA) : Jean MICHELON (Maire)
CROCQ : Denis LAMY (Maire), Jean-Marie BATTUT (M. Adjoint) CROZE : Camille ROUBY (M. Adjoint)
DOMEYROT : Henri MALLY (Maire) DONTREIX : Gérard GUERY (C.M.)
DONZEIL (LE) : Georges ROMANET (Maire) EVAUX-LES-BAINS : François RADIGON (C. M.)
FAUX-LA-MONTAGNE : François CHATOUX (Maire), Huguette PEYRISSAGUET, Odette ORLIANGE (M. Adjoints)
FELLETIN : Pierre GAUDON (Conseiller Général et C. M.), Henri ROUDIER, Roland NICOUX (C. M.)
FENIERS : Pierre LAURENT (Maire et Conseiller Général)
FONTANIERES : Suzanne LECERF (Maire)
FRANSECHES : Daniel DELPRATO (Maire)
GENTIOUX PIGEROLLES : Pierre DESROZIER (Maire)
JALESCHES : Alphonse GESSET (Maire)
LAVAUFRANCHE : Robert LAMIER (Maire)
LEPAUD : Dominique BIOU (C. M.) LEPINAS : Arsène SALANDROUZE (Maire)
LEYRAT : Jean GRANDJEAN (Maire) LUPERSAT : Michel MOREIGNE (Maire et Conseiller Général) LUSSAT : Gérard AUBERT (Maire)
MAGNAT L'ETRANGE : Joseph DUBOSCLARD (Maire)
MAINSAT : Henri TIXIER, André JOUHANIQUE, Jacqueline JARY, René MAGNIER (Maires Adjoints) et les Conseillers Municipaux
MAISONNISSES : Christian LARDY (M. Adjoint)
MALLERET : Georges TOURNEBISE (M. Adjoint) MALLERET BOUSSAC : Georges PENNETIER (Maire)
MARS (LES) : Lucien BUSSIERE (C. M.) MAS D'ARTIGE (LE) : Lucien DEPLAGNE (Maire) MERINCHAL : René FONTY (M. Adjoint)
MOUTIER D'AHUN : Jean-Claude TRUNDE (Maire)
MOUTIER ROZEILLE : Gaston CREPIAT (M. Adjoint) NOUHANT : René CHAUBRON (Maire) NOUZERINES : Robert BRUNET (Maire) NOUZIERS : Armand PRUDHOMME (Maire)
PEYRABOUT : Roland SUCHAUD (Maire)
PEYRAT-LA-NONIERE : Robert GUILLOT (M. Adjoint), Jean-Denis BOURCY (C. M.)
PIONNAT : Jean-Pierre BARJAT (M. Adjoint)
PONTARION : Jacky GUILLON (Maire) PUY-MALSIGNAT : Olivier RIMAREIX (C. M.)
RETERRE : Pierre NORE (Maire), Paul COIFFE, Daniel GATIER, Laurent MERCIER (M. Adjoints) RIMONDEIX : Raymond AUCOURDIER (Maire)
ROCHES : Sylvie MARTIN (Maire)
ROUGNAT : Monique BOUCHET (C.M.) ROYERE-DE-VASSIVIERE : Jean-Luc BUGEAUD (Maire), Jean-Louis
BORDIER, Christian BERNARD-GRIFFITHS (M. Adjoints) SAINT-AGNANT-PRES-CROCQ : Daniel MONTMANEIX (Maire)
SAINT-ALPINIEN : Sthéphane DUMONTANT (Maire) SAINT-AMAND : Henri GUYONNET (M. Adjoint) SAINT-AVIT-DE-TARDES : Guy LAURADOUX (Maire)
SAINT-CHABRAIS : Jean DUCOURTHIAL (C.M.)
SAINT-ELOI : Albert BAYON (Maire)
SAINT-FRION : Christian ARNAUD (C. M.)
SAINT-GEORGES-LA-POUGE : Jean-Pierre TERME (Maire) SAINT-HILAIRE-LE-CHATEAU : Bernard RAYNAUD (Maire)
SAINT-JUNIEN-LA-BREGERE : Albert JALINAUD (Maire)
SAINT-MAIXENT : Robert DUPRAT (M. Adjoint)
SAINT-MARC-A-FRONGIER : André ROUGIER (Maire)
SAINT-MARIEN : Albert BEUZE (Maire)
SAINT-MARTIAL-LE-VIEUX : Jean MONTEIL (Maire)
SAINT-MARTIN-LE-CHATEAU : Georges BARLET (Maire). André JOFFRE (Adjoint) SAINT-MAURICE-PRES-CROCQ : Robert BARDET (Maire)
SAINT-MERD-LA-BREUILLE : Ginette LAURELUT (Maire)
SAINT-MICHEL-DE-VEISSE : Camille TRUNDE (Maire)
SAINT-MOREIL : Albert JOUANNAUD (Maire), Marcel POULIER (Maire honoraire)
SAINT-ORADOUX-DE-CHIROUZE : Marcel MAGINIER (Maire)
SAINT-PARDOUX-LE-NEUF : Jacques BRUN (M. Adjoint)
SAINT-PARDOUX-MORTEROLLES : Bernard LABORDE (Maire et Conseiller Général), Robert JAMILLOUX, Gilbert SIMONET (M. Adjoints) SAINT-PIERRE-BELLEVUE : René PAROT (Maire), Guy ULMET (M. Adjoint)
SAINT-PRIEST : Albert BONDIEU (Maire)
SAINT-SILVAIN-BAS-LE-ROC : Maurice LEPRAT (Maire) SAINT-SILVAIN-SOUS-TOULX : Bernard SUREAU (C. M.) SAINT-YRIEIX-LA-MONTAGNE : Jean-Louis DELARBRE (Maire), Maurice MAGOUTIER (M. Adjoint)
SAINT-YRIEIX-LES-BOIS : Jean-Louis THIBORD (Maire) SANNAT : Henri SAUTHON (Maire), Alain SIMONET (C. M.) SARDENT : Claude CHAZEIRAT (Maire et Conseiller Général)
SERRE BUSSIERE VIEILLE (LA) : André THURET (Maire honoraire), André FAYOLLET (C. M.)
SOUS-PARSAT : René PARTON (Maire)
TARDES : Jean-Baptiste LAUBELY (Maire) TERCILLAT : Raymond DESJOBERT (Maire), M. Guy AUGER (M. Adjoint) TOUX-SAINTE-CROIX : Paulette CHANTEMILANT (Maire)
TROIS-FONDS : Fernande ALANORE (Maire)
VIDAILLAT : Martine LAPORTE (M. Adjoint) VIERSAT : Marie-Thérèse PELLETIER (Maire)
Le dimanche 28 mars, ne vous abstenez pas, votez Gaston RIMAREIX
IMP MARCHOISE. AUBUSSON